ShiftDisplay	KEYWORD1

set	KEYWORD2
changeDot	KEYWORD2
changeCharacter	KEYWORD2
setAt	KEYWORD2
changeDotAt	KEYWORD2
changeCharacterAt	KEYWORD2
update	KEYWORD2
clear	KEYWORD2
show	KEYWORD2

DisplayType	LITERAL1
DisplayDrive	LITERAL1
Alignment	LITERAL1
ALIGN_LEFT	LITERAL1
ALIGN_RIGHT	LITERAL1
ALIGN_CENTER	LITERAL1
COMMON_ANODE	LITERAL1
COMMON_CATHODE	LITERAL1
MULTIPLEXED_DRIVE	LITERAL1
STATIC_DRIVE	LITERAL1
